111111111111111111111111111111111111111111111
100000001000000000000000100000010000000000001
111**1111****11111111001110000001000001111001
1000000000000000000111111******11111001000001
10000000000000000001000000011111100*001111001
1***11111111111*11111111000000011001000001001
10000000*0000000000000010000000**001***111111
11111***1111111111*****111****111111000000001
100000000000010000000000000011100000000001111
100000000000011111111**1110000000000000000001
1***1111111***000000000001111111111***1**1111
100010000000011111111000000100000000001000001
10011000000000000000100000*1****1*****1111111
1001****11111**11111111*110000001110001000001
100000001000000*00001000000010001000001110001
1111*1111**111111000100000111000100000*000001
100000100000001000001111001000001111111111111
1000001**111111**000100111100000*000000000001
100000*0000000000111100000001**11111100000001
11111111111100000000*001111110000000111111111
100000000000001111111000000**0000000000000001
1**111111111**000000*001111110000000000000001
10010000000000010000*0000000111111**111111111
100000000001111100001111000000000100000000001
111111111111111111111111111111111111111111111