111111111111111111111111111111111111111111111
100000000000000011000000000010000000111111001
111**111111*****11111111100110001100000000001
100000010000111000010000000000001111111000111
100000010000000000011111100111111000000010001
11111**11111110000000000000000001001000010001
100000000000000011111111000000000001000111111
11111***1111100000*****1100000111111100000001
100000000000111111111001100111100000000001111
100000000000100000000000000000000000000000001
111111**1111111100**1111111111111111**1**1111
100000001000000111000000000100000000001000001
1**0000010000000000000000001***0111***1111111
1001111111111****111111*11000000111***1000001
100000000000100000001000110011111000001110001
111111111**111111***1000000000001001110011001
100000000000001000001111001111111000000000001
10011111**11111100111001000000001111110011001
100000**00000000100100000111110000000000**001
111111111**111111100*000010001**1111111111111
100000000000000000111000010101000000000000001
1*1111111111****00000110010101000000001111001
10000000000000111100***0000101111111001000001
100011111111000001101111110100000000001000001
111111111111111111111111111111111111111111111