111111111111111111111111111111111111111111111
100000000000100000000000100001111111000100001
111**00001000**111111**11001110000**000110001
100001111111100000001**01**000001111100011001
100000000100000111001000000111100000100001001
1**11111111111**01111111000100011000100000001
1000000000000000000000010001000000001**111111
11111***1111111111**1**111**00111111100000001
100000100000010000001000010011100000000111111
10000010000001000111011000000*000111000000001
1**111111100011111**000001111110000***1001111
100100000001110000001111110000111111011000001
1001000000000000000000000001**1*0*****1111111
100111**1111111**111111*111100101110001000001
100000001000000000001000100000101000111110001
1111**111**11*100***1000*00111101000000011001
100000100010001111111111*00000001111011111001
10001111111***0000001001110001101000000001001
100100*00000001111001000011100**1000001000001
101111111**111100000*000111111**111111**11111
10000000000000111111100010000000**000000*0001
1***11111111000*000*****1**111111111111110001
10001000000*000100011111100*00000000000*00001
10001000000*000100000100000111111111111100001
111111111111111111111111111111111111111111111